##################
#A.#.c...c###..c.#
#..###....#.#.k..#
#c.####...##.....#
#..#..#ccc###.e..#
#.c...cccccc.....#
#.....cccccc.....#
#c.#....#.e......#
#..#....#........#
#.c#....#......B.#
#..####.####h....#
#k...e.c.c..k....#
#.....####.......#
#.....#e.#..h.h..#
#..c.c####.......#
#................#
##################