##################
#..####..c#.#..c.#
#..#..#....#..k..#
#c.###.....#.....#
#..#..ccc..#..e..#
#.c...cccc.......#
#..a..cc.........#
#c#####.#.e.#....#
#...#...#####....#
#.c.#...#####..B.#
#...#...#...#....#
#k...e.c.c..k....#
#.#####...##h.#..#
#.#...#e..#.#.#..#
#.#...#...#..##..#
#.#####...#...#..#
##################