##################
#..######..####..#
#..#....#....#..k#
#..###.....###..E#
#..#..###..#...#.#
#.#....##...h.####
#..#....#........#
#..#######..###..#
#...E......##....#
#..##...###..#...#
#..#..#..##..#..b#
#..#..#..#...#...#
#..#..#..#...#..E#
#..###...##.###.##
#..........#.....#
#..######.#####a.#
##################
